

SO           test.xpm     test  

         NO       test.xpm   sd


 



EA  test.xpm                         fff

WE             test.xpm ooga booga



F 255,255,255     

C  255,255,255 


    111111111
   100N0001  
  11000001111
   1111111111