

SO              test.xpm caca    

         NO       test.xpm   sd


 



EA  test.xpm                         fff

WE             test.xpm ooga booga


F 255,255,255

C  255,255,255 


11111111111111111
10000000000000001
10000000000000001
10000000N00000001
10000000000000001
10000000000000001
10000000000000001
10000000000000001
14444444444444444
