11111111111111111
00000000000000000
44444444444444444
