

SO         south.xpm       north  

         NO       north.xpm   sd





EA  east.xpm                         fff

         WE             west.xpm              sfsdf


F 0,255,255     

C  255,0,255 

      11111111111111   
      10000000000001   
      10000000000001   
      100000N0000001   
      10000000000001   
11111 10000000000001   
      10000000000001   
      11111111111111   