

SO         max.xpm       max  

         NO       max.xpm   sd





EA  max.xpm                         fff

         WE             max.xpm              sfsdf


F 0,255,255     

C  255,0,255 

11111111111111
10000000000001
10000N00000001
10000000000001
10000000000001
10000000000001
10000000000001
11111111111111