


         NO         lol                

 
SO                    tt tt 



EA   texteast                

WE   tesxtwest


11111111111111111
00000000000000000
14444444444444444
